Samuel Mason - smason0@istockphoto.com
Sara Stewart - sstewart1@goo.ne.jp
Pamela Garcia - pgarcia2@sourceforge.net
Sara Lawson - slawson3@uiuc.edu
Norma Gray - ngray4@noaa.gov
Edward Ellis - eellis5@comcast.net
Aaron Matthews - amatthews6@theglobeandmail.com
Jose Smith - jsmith7@hubpages.com
Howard Myers - hmyers8@cafepress.com
Daniel Larson - dlarson9@scientificamerican.com
Annie Garrett - agarretta@washington.edu
Joe Flores - jfloresb@clickbank.net
Dennis Snyder - dsnyderc@joomla.org
Jerry Stevens - jstevensd@wikia.com
Nancy Harvey - nharveye@sbwire.com
Jessica Harrison - jharrisonf@ucoz.com
Albert Kennedy - akennedyg@google.com.hk
Steve Howard - showardh@sitemeter.com
Janet Castillo - jcastilloi@parallels.com
Martin Scott - mscottj@shinystat.com
Phillip Stanley - pstanleyk@people.com.cn
Harold Washington - hwashingtonl@loc.gov
Patrick Henderson - phendersonm@google.de
Martin Simmons - msimmonsn@businessweek.com
Martin Stevens - mstevenso@sitemeter.com
Louis Boyd - lboydp@reddit.com
Donna Nichols - dnicholsq@weibo.com
Susan Walker - swalkerr@stanford.edu
Lori Coleman - lcolemans@homestead.com
Samuel Peters - speterst@youtu.be
Roger Hill - rhillu@wikispaces.com
Gary Richardson - grichardsonv@oakley.com
Christopher Hudson - chudsonw@mediafire.com
Donna Powell - dpowellx@gov.uk
Teresa Freeman - tfreemany@bizjournals.com
Margaret Graham - mgrahamz@friendfeed.com
Carolyn Washington - cwashington10@moonfruit.com
Dennis Mason - dmason11@yellowpages.com
Alice Webb - awebb12@netscape.com
Alice Matthews - amatthews13@naver.com
Lillian Franklin - lfranklin14@sfgate.com
Matthew Burns - mburns15@quantcast.com
Victor Moore - vmoore16@tiny.cc
James Ramos - jramos17@shinystat.com
Andrea Murphy - amurphy18@cafepress.com
Shawn Romero - sromero19@loc.gov
Roger Morales - rmorales1a@spotify.com
Tammy Hudson - thudson1b@ed.gov
Kathleen Elliott - kelliott1c@macromedia.com
Ann Chavez - achavez1d@usgs.gov
Martha Murphy - mmurphy1e@census.gov
Dorothy Smith - dsmith1f@unesco.org
Douglas Edwards - dedwards1g@chronoengine.com
Frank Gordon - fgordon1h@blogspot.com
Joshua Rivera - jrivera1i@cnbc.com
Arthur Williamson - awilliamson1j@salon.com
Ann Garcia - agarcia1k@sogou.com
Janice Gray - jgray1l@so-net.ne.jp
Dennis Mcdonald - dmcdonald1m@amazon.com
Lori Robinson - lrobinson1n@forbes.com
Samuel Robinson - srobinson1o@apache.org
Ruth Baker - rbaker1p@businesswire.com
Debra Gordon - dgordon1q@joomla.org
Daniel Bryant - dbryant1r@blinklist.com
Bobby Bradley - bbradley1s@wired.com
Kevin Banks - kbanks1t@unc.edu
Jason Meyer - jmeyer1u@jigsy.com
Ruby Edwards - redwards1v@webs.com
Brandon Thompson - bthompson1w@hud.gov
Mary Watkins - mwatkins1x@eepurl.com
Jean Wright - jwright1y@multiply.com
Antonio Webb - awebb1z@engadget.com
John Fuller - jfuller20@thetimes.co.uk
Lisa Gilbert - lgilbert21@nbcnews.com
Beverly Alvarez - balvarez22@java.com
Jason Morris - jmorris23@geocities.com
Rebecca Schmidt - rschmidt24@intel.com
Patricia Thompson - pthompson25@lycos.com
Patrick Morris - pmorris26@ihg.com
Kathy Freeman - kfreeman27@soup.io
Dennis Hayes - dhayes28@ask.com
Frances Davis - fdavis29@bloglines.com
Steven Day - sday2a@gravatar.com
Daniel Carter - dcarter2b@about.me
George Armstrong - garmstrong2c@miibeian.gov.cn
Peter Evans - pevans2d@pbs.org
Jerry Peterson - jpeterson2e@linkedin.com
Kimberly Murphy - kmurphy2f@123-reg.co.uk
Ashley Gordon - agordon2g@hud.gov
Antonio Oliver - aoliver2h@4shared.com
Emily Fuller - efuller2i@godaddy.com
Stephen Brown - sbrown2j@wisc.edu
Thomas Smith - tsmith2k@dedecms.com
Teresa Ryan - tryan2l@paypal.com
Angela Freeman - afreeman2m@tiny.cc
Virginia Hicks - vhicks2n@google.com.hk
Alice Kennedy - akennedy2o@deliciousdays.com
Janice Sullivan - jsullivan2p@youku.com
Ryan Miller - rmiller2q@linkedin.com
Jesse Wright - jwright2r@nifty.com
